100
15 10
CCYC CCCC YYYY YYYY YYYY YYYY YYYY YYYY YYYY YYYY YYYY YYYY YYYY YYYY CCCC
YYYY GGGG GGGG GGGG GGGG GGGG GGGG GGGG GGGG YYYY YYYY YYYY YYYY YYYY CCCC
YYYY GGGG RRRR RRRR RRRR RRRR RRRR RGRR GGGG RRRR YYYY YYYY YYYY YYYY CCCC
YYYY GGGG RRRR BBBB BBBB BBBB BBBB BBBB GGGG RBGR BBBB YRMY YYYY YYYY CCCC
YYYY GGGG RRRR BMCG MMMM MMMM MMMM MMMM GGGG RRRR BBBB MMMM YYYY YYYY CCCC
YYYY GGGG GGGG GGGG GGGG GGGG GGGG GGGG GGGG RRRR BBBB MMMM YYYY YYYY CCCC
YYYY YYYY RRRR RRRR RRRR RRRR RRRR RRRR RRRR RRRR BBBB MMMM YYYY YYYY CCCC
YYYY YYYY YYYY BBBB BBBB BBBB BBBB BBBB BBBB BBBB BBBB MMMM YYYY YYYY CCCC
CCCC CCCC YYYY MMMM MMMM MMMM MMMM MMMM MMMM MMMM MMMM MMMM YYYY YYYY CCCC
CCCC CCCC CCCC CGYC YYYY YYYY YYYY YYYY YYYY YYYY YYYY YYYY YYYY YYYY CCCC
17
Loot 1,4 1000
Loot 1,6 550
Loot 7,3 300
Loot 3,6 250
Loot 7,0 150
Loot 8,6 150
Loot 5,9 150
Loot 12,9 150
Clock 7,5 15
Clock 10,8 15
Lever 9,3 R
Gate 0,9 false R
Lever 9,8 B
Gate 6,2 false B
Bomb 5,1 4
Bomb 10,2 4
Door 7,9 false
5
FlyingAssassin 0,4 e
FlyingAssassin 14,5 s
FloorFollowingThief 3,7 e B
FloorFollowingThief 9,6 s R
SmartThief 10,5 n
Player 0,0