100
15 10
CCCC CCCC CCCC CCCC CCCC RRRR CCCC CCCC CCCC CCCC CCCC CCCC CCCC CCCC CCCC
CCCC CCCC CCCC CCCC RRRR RRRR YYYY YYYY CCCC CCCC CCCC CCCC CCCC CCCC CCCC
CCCC CCCC CCCC RRRR RRRR RRRR YYYY YYYY YYYY YYYY CCCC CCCC CCCC CCCC CCCC
CCCC CCCC RRRR RRRR RRRR RRRR YYYY YYYY YYYY YYYY YYYY YYYY CCCC CCCC CCCC
CCCC RRRR RRRR RRRR RRRR RRRM YYRY YYYY YYYY YYYY YYYY YYYY YYYY YYYY YCCY
CCCC MMMM MMMM MMMM MMMM MGMM YGGG GGGG GGGG GGGG GGGG GGGG GGGG GGGG GCCG
CCCC CCCC MMMM MMMM MMMM MMMM GGGG GGGG GGGG GGGG GGGG GGGG CCCC CCCC CCCC
CCCC CCCC CCCC MMMM MMMM MMMM GGGG GGGG GGGG GGGG CCCC CCCC CCCC CCCC CCCC
CCCC CCCC CCCC CCCC MMMM MMMM GGGG GGGG CCCC CCCC CCCC CCCC CCCC CCCC CCCC
CCCC CCCC CCCC CCCC CCCC MMMM CCCC CCCC CCCC CCCC CCCC CCCC CCCC CCCC CCCC
17
Loot 1,4 1000
Loot 1,6 550
Loot 7,3 300
Loot 3,6 250
Loot 7,0 150
Loot 8,6 150
Loot 5,9 150
Loot 12,9 150
Clock 7,5 15
Clock 10,8 15
Lever 9,3 R
Gate 0,9 false R
Lever 9,8 B
Gate 3,3 false B
Bomb 5,1 4
Bomb 10,2 4
Door 7,9 false
5
FlyingAssassin 0,4 e
FlyingAssassin 14,5 s
FloorFollowingThief 2,7 e C
FloorFollowingThief 9,6 s G
SmartThief 10,5 n
Player 0,0

