100
15 10
CCCC CCCC CCCC CCCC CCCC CCCC CCCC CYCC CCCC CCCC CCCC CCCC CCCC CCCC CCCC
CCCC CCCC GGGG CCCC CCCC YYYY YYYY YYYY CCCC CCCC CCCC CCCC CCCC CCCC CCCC
CCCC CCCC GGGG GGGG YYYY YYYY YYYY YYYY YYYY YYYY CCCC CCCC CCCC CCCC CCCC
CCCC CCCC GGGG YGGG GGGG YYYY YYYY YCYY YYYY YYGY YYYY YYYY CCCC CCCC CCCC
CCCC GGGG GGGG GGGG GGGG YYYY GGGG GGGG YYYY YYYY YYYY YYYY YYYY YYYY CCCC
CCCC GGGG GGGG GGGG GGGG YYYY GGGG GGGG GGGG GGGG GGGG GGGG GGGG GGGG CCCC
CCCC CCCC GGGG GGGG YYYY YYYY GGGG GGGG GGGG GGGG GGGG GGGG CCCC CCCC CCCC
CCCC CCCC GGGG YYYY YCYY YYYY GGGG GGGG GGGG GGGG CCCC CCCC CCCC CCCC CCCC
CCCC CCCC GGGG CCCC YYYY YYYY GGGG CGGG CCCC CCCC CCCC CCCC CCCC CCCC CCCC
CCCC CCCC CCCC CCCC CCCC CCCC CCCC CCCC CCCC CCCC CCCC CCCC CCCC CCCC CCCC
19
Loot 1,4 1000
Loot 1,6 550
Loot 13,6 300
Loot 10,4 250
Loot 7,3 300
Loot 3,6 250
Loot 7,0 150
Loot 8,6 150
Loot 5,9 150
Loot 12,9 150
Clock 7,5 15
Clock 10,8 15
Lever 9,3 R
Gate 0,9 false R
Lever 9,8 B
Gate 6,2 false B
Bomb 5,1 4
Bomb 10,2 4
Door 1,0 false
5
FlyingAssassin 1,4 n
FlyingAssassin 14,4 e
FloorFollowingThief 3,7 e Y
FloorFollowingThief 9,5 s G
SmartThief 10,5 n
Player 0,0